########################################################################################
#           |                                                              |           #
#           |                                                              |           #
#           |                                                              |           #
#           |                                                              |           #
#           |                                                              |           #
#           |                                                              |           #
#           |                                                              |           #
#           |                                                              |           #
#           |                                                              |           #
#           |                                                              |           #
#           |                                                              |           #
#           |                                                              |           #
#           |______________________________________________________________|           #
#          /                                                                \          #
#         /                                                                  \         #
#        /                                                                    \        #
#       /                                                                      \       #
#      /                                                                        \      #
#     /                                                                          \     #
#    /                                                                            \    #
#   /                                                                              \   #
#  /                                                                                \  #
# /                                                                                  \ #
#                                                                                      #
########################################################################################
