##########################################################################################
#            |                                                               |           #
#            |                                                               |           #
#            |                                                               |           #
#            |                                                               |           #
#            |                                                               |           #
#            |                                                               |           #
#            |                                                               |           #
#            |                                                               |           #
#            |                                                               |           #
#            |                                                               |           #
#            |                                                               |           #
#            |                                                               |           #
#            |                                                               |           #
#            |                                                               |           #
#            |                                                               |           #
#            |_______________________________________________________________|           #
#           /                                                                 \          #
#          /                                                                   \         #
#         /                                                                     \        #
#        /                                                                       \       #
#       /                                                                         \      #
#      /                                                                           \     #
#     /                                                                             \    #
#    /                                                                               \   #
#   /                                                                                 \  #
#  /                                                                                   \ #
# /                                                                                     \#
##########################################################################################
